double_probing 4096

1111111111111010111111111111111111111001111111111111111111110111111111111111111111111111110111111111
1110011111011111111111111111011111111101111111111111101111111101111111111111111111111111111110111111
1111111111111111101101111111101111111111111111111111111101111111011111111111111001110111111111111111
1111111111111111111111111111111111111111111111111111111111111111111111111111111011111111110111111111
1110111111111001111111111111111111111111111111011111111111011111111111111111111111111101111011111110
1111111110111101111111111111111111011111111111111111111111111111111111111111111011111111111111101111
1111111110111111111111111111111011111011111111111111101110111111111111111111111111111111111111111101
1110111111011101111111111111111110111111111111111111011111111111111111111111111100111111111111111111
1111111111111111111111111111111111111111011111111111111101111011111110111010111111111111101111111111
1111110111111111111111111111111111011111111111011111111111111111101111111111111101111111111111111111
1111111111101111111111111011111111111011101111111111111111111011011111111111111111111111111110101111
1111111101011011111101111101111111111111111111111111111111111101111111111111111111111111111111101111
1111111111111111111011111011111111111111111111101111111111111111111111111011111101111111111111111111
1111101111111111111111111111111111111110101111111111111110111111111111111111111111111111111111101111
1111101111111111111101111111110111110111111111111111111111111111111111111111111111011111111111111111
1111111111111111111111111111111111111111111111111111110111111110111111111111111111111101111111011111
1101111111111111111111111111111111111111111111011111111111111110111111111111111111111111110110111111
1111111111111111111111111110111111011111111111111111111111111111111111111111111111111111111111110111
1110111110111111111111111111111111111111111111111111111111111111111111111111111111111111111101111110
1111011111111111011110110111111111111111111111110111110111111111011111110111111111110111111111111111
1111111111111111101111111111111111101011111111111111111111111111111110101111111111111111111111011110
1111111111111111111111111111111111111111111111111111111111111101111111111111111110111001111111111101
1111111111111111111111111101011111111111111111111111111111111111111111111101111111111111111111111011
1111111111111111111111111111111111111111111111111111011011111111111111111111111111111111111010111111
1011111111111111111111111111111011101111111111111111111111111111111111111110111111011111111111111111
1111111011011111111111111111111111111111111111111111111011110111111111111111111011111111111111111011
1111111111111111111111011111111111111111101111111111111111111111111111111111011111111111111111011111
1111111110111111111111111110111111111111111111111111111111111111111011111101111111111101111111111111
1111111011111110111111111111111111111111111111110111111111111111111111010110111110111111111111111111
0111111111101111111111111111111111111111111111001111111111111111111111101111111111111111111111111111
1111111111111110111111111001111111111111111111111111110111111111111011101111111111111111011111111111
1111111111111111111111111111111111110011111111111111111111111111111111111111111111111101111111111111
1111111111111111111111111111111111111111111111110111111111111101111111111111111111111111111111111111
1110111111111111011111111111111111111011111111111111111111111111111111111111101111111110111111111111
1111111111111111111111111111111111111111111111111111111111111111111111010111111101111111111111111111
1111111111111111111011111111111111111111111111111111111111111111111110111111111111110111111111111111
1111111111111111111111111111101111011111111011111111111111111111111111111111111111101111111111111111
1111111111111101111111111111111111111111111111011111111111111011111111101111111111111111111111111011
1111111111110111111111011111111111111011111111110111111111111011111111111111111111101111101101111111
1111111111111111111111110111111111011111110111111111111111101111111111111111101111111111111111111111
1111110101111111111111111111111011111111111111111111111111111101111111111111111111111011111111111111
1011111111111111111101011011111111111111111111111111111111111111111111111101111111111111111101110111
1101011111111111111111111111111111110111111111111111111111111111111111111111111111111111111111111101
1111111111011111111111111110111111111111111111111111111110111111111111111111111111111011111111111111
1111101011111111111111111111111111111111111111111111111111101111111111111111111111110111111111111111
1110111111111111111111111111111110111111111111111111111111111111111111111101111111111111111111111111
1111111111011111111111110111111111111111111101111111111111101111111111111111101111111111111111111111
1111111111111111111111111111111111111111111111011111111111111111111111111101111111111111111111111111
0111111110111111111111111111111111111111111111111111111111111111111111111111111111111111111011111111
1111111111111111111111111111111111111101111111111111111111111111111111111111111111111111111111111111
1111111111111111011111111111111111111111111111111111101111111111111111111111111101111111111111111111
1

1111110111011010110111101011100010001101111101111111110111111111011111111010110011110111110110111101
0100011100011101111100110111011011111001011011110111101101110101101111111101111111011101111101110011
1111111111111111001001111110011101111110111111111111001111111111011111111101011000110111111111111011
1110111101111110111011101111110011101111011110101111111110111101011111111111111011111011010011101111
1111111111000001110110111111111011111110110001101101011111011111111011111101100011011101111111111110
1111111011111010101111111111110111011100111101111110111111101111111101101101111011111111101111111111
1111111110111110111011011111010001111001111111111111100001111101100101111111101100111101110111111111
1110010111011111111110101111010111111011111110110001111111111111110111111111101110111101111111111111
0111101100111011101110011011110001011000011000101011111011111111111110110110111111111111100011001011
1111111010110101111010111111111101011111111011011011110111010111001111110100011011100111111111110101
1110010111011110111100011111111111010001101110111111111111101111011111111011111111010111111011111111
1111111101100001011111111100011111111111110111100111111111011101011111111100011101101110111111101111
0110001111111111111110111010100111111110111111101101110101111111111111110010111101111110111101011001
1111101111111011100011111111111111111111101110111110111100100111111111111111111100101110111110111110
0111011001111111011101111111110110110110101111011110100111011011111111110111110101011011101111110111
0111111111101111100101010111011111111111011111001111110011111110110000110111111111011100111011101100
1111111101111010111101111111101011111111110111011111111111010100111011110111111101111110111010111101
0111111111111111111011110100101110101011111101101101111101111111111111101110111111001011101111110111
1100110110101101111101101110111110111111100011011111111011100001100101111100111100111111101101111111
1001011011111111010010110001111111111110101111110001111101011101011111011001011101010111110011110111
1101011110111111111101111111111111111111111101110101111111101111110111010111111010010110111000111110
1101101111111110011111111011111111101010111111111111111111011101101111111111111110111101111111010101
1111101111111111110110110111100111111100111001111110110101110111111101011111011111010011111111111111
1111111111110111111101011101111111111111101111111111011001011111111101110101101100111111011110111111
1010110101111111100100011111001110101110101011011111110011111111111110100110111111111011111111110110
1110111011111111111011011111111101111111111111111101100011111111111110110111011011111011111111111001
1101111111111011111111011100111111011101100111111111111011111001111110111101011110111110111011111111
1110010111111111111010111111101111111111111101110011100111100111111011011101111001111101101111111110
1011101010111010110111011111111110011111110101011101111011111111011111110110111110111111111111111110
0111001111101111110110111111110111111111111111001101110111011001111111111111111111011110111111101101
1001111111011110101101011011111111111111101010111111111111101111111011101110011111111111011101101001
1111011111111011111011101110010111111010111111110111110111001111011111111110111111111111111011111111
0101111111101111101111011111111111111111110100111111111111111101111110110111111111100111111111011111
1000111111011011011011111110111101111010110111011111101110011111101110101101101111111111011011110111
1111111110111111101111111110110111111101011011111011111011111111110110000011101101111101110011111111
1111011111111110111011110111111101110111101111111111110011111111111110111011011110111011111111111111
1111101111111011011111111011111111111111111011111111111111111111111111111011011111111011111111111101
1110011111111000111111111011111110111010111111011111111111110110000111111111111111110110101111111101
1111111111110111111111011111111011111011111110100111111101110111111010111101101111101101011001010111
1011111111111011111110110111011101100111101111110110111011100101111111111110101111111110111111111111
1111110101101011111101111111111011011110101011101110110011111001111111011111111111111100111110111111
1011111111111111111101011111101111111111111111111111011111110111011101100111011101011111111101110100
1111011111101011111010111111111111110111010011111111111111110111110110110110110010111111111111111101
0111111111111111011111101110111001101111111001111101101110000111101100100101101011101011111011111111
1111111111101111111011111111111111111111111111111011111101101001111110111101011111101111111011111101
0110101111101111111111111100111111101101011011011101111001111110111111011100111111110110111111111111
1111111110011011011011110111110101111011101110101111011111001101111111111111101111101111101011100111
1110011111111111101110111111111111111111111111011111111111111001101111111101111100110111110111111111
1111111111110110011111111111100010111110111110111011111111111110111111110110111011111111111111111111
1111111111111111111111111111111111111101001011110111111111111111111111111111111111111111111111110111
1111101111101111011111110111111111111111110111110111101111111111111111111111111101111111111011011111
1
